--B---------?--M-------?-------------------------------------------------X-----------------------o--------o---?----------------------------------------------------------o---------X--------------------
------------------------------------------------------------MB----------------------------M----------------------o---------------------?----X------------------?----------------------------------------
------------------------B---------o-------X------------------------------------------------------------------B------------------------------?---------B------B---------------------?--------------------
----?X--------X---------------------------------M?----------M--B-------------B-----?X--B---------B--------------------X?---------?-------?X?------?------------------------X--B--------XM-------------B-
-BB--B--B---------------?---B-----------M--------X---------B-X------BM----X-------------------------------------M----------B-----------------------M?-------B-----------------X-----------------------M-
---?-------------B-----------B---?----------?-------?----B-------------?--------X--------------?M-M---------------------------------?M---B-B------------B---B-----------------B-------B--X----------B---
------------M--------X-----B-------MB----------------------------------------------B------X--------?--------------B-----X-------------X--B------?--MX-----------M--------B---?X-------------------------
---------------------------X--M-------------X------MX--------B------------------------B------M---B------------o-------?--M----------B---?-----M?-MX------------X------M---M-----M------------X-?M----?-v
------M-------?---M-----------------X--X---M----X-BX-X--------------B-------------------------B--BXB-B-------------X------------------------------MM-------------M---------?--B-------X---------M------f
-----------MB---M-------?-----??-B---??---------------?----?-----------X-----?--------------------------------B---X----X--------X---M-B-------------------------M--------------------M----BM-B--B------f
----------X---------B-?----M------------------------X-------?-------X--?M------------X---X------B----X------------------------X-XB------M-?--M---------X----------M-?--B-X------------------?--B---X---f
----B-----------------------?------------------??---M-X--------X-------------------------------?--------?----------??X---M-M---------------------------X---------B--------------?---B--------B---------f
--------B----M----X-------B--------B-B--------B-B------------------X-------------------BX---B----------------??-----------------MM-------X----------------?-------------M-------------B-------------X--f
------X--------?----M---------------------X----M------------------------?----M-------B--X-------------------X--B---------------------B-------------X----B-----------------------X-------------B?-----B-f
mX--------X---------------M------------M--X-----------------M---?-----------X----X--M--X--B---XB--------------X---X-----X---XX----X-X-------?--------------X-------X--------X--X-----X------MX---------X
XXMXXXXXXXXXXXXXXXXXXXXXXXXXXXXXXXXXXXXXXX-XXXXXXoXXXXXXXX?X?XXXXXXXXXXXXXX-XXXXXXXXXXXXXXXXXX?XXXoXXXXXXXXXXX-XXXBXXXXXXXXXXXXXXX-XXXXXXXXXXXXXXXXXXXXXXX-XXXXXXX-XXXXXXXXXXXXXXXXXXXXXXXXXX-XXXXXXXXXX
